11111111
10010001
1C010101
10C0C0P1
1E0C0011
11111111